Plugins Notes

snipMate / UltiSnips / neosnippet

Sparkup vs ZenCoding

netrw vs NERDTree

Autocomplete and Snippets: Snipmate/UltiSnips + SuperTab + AutoComplPop
	neocompletecache + neosnippet
	YouCompleteMe(compiled YCM), neocomplete(lua)

Alignment:tabular, align, alignta

Plugin Management: Pathogen, Vundle, NeoBundle
File Searching: CommandT(In Ruby), CtrlP, FuzzyFinder
auto bracket: auto-pairs, delimitMate

@ 2013-07-01 10:57
remove vim-support
remove bufexplorer

unites.vim: this is an extremely powerful plugin that lets you build up lists from arbitrary sources

easymotion: easily jumps to any character on the screen

fugitive: git wrapper

gitv: nice log history viewer for git

unimpaired: many additional bracket [] maps

nerdtree: file browser

ctrlp: fuzzy file searching

tabular: easily aligns code

neocomplcache/neosnippet: autocomplete/snippet support as a fallback choice when YCM and/or python is unavailable
	<Tab> to select the next match, or expand if the keyword is a snippet
	if you have lua installed, it will use neocomplete instead

multiple-cursors:  select all matching words and lets you concurrently change all matches at the same time

surround: makes for quick work of surrounds
repeat: repeat plugin commands
speeddating: Ctrl+A and Ctrl+X for dates
matchit: makes your % more awesome
syntastic: awesome syntax checking for a variety of languages
bufferline: simple plugin which prints all your open buffers in the command bar
indent-guides: vertical lines
signify: adds + and - to the signs column when changes are detected to source control files (supports git/hg/svn)
delimitmate: automagically adds closing quotes and braces
startify: gives you a better start screen
commentary: nice comment
ColorV: is a color view/pick/edit/design/scheme tool
Conque-Shell: is a Vim plugin which allows you to run interactive programs, such as bash on linux or powershell.exe on Windows, inside a Vim buffer